#################################################################################################################################################################################### 
#  ##     ## ########     ########################################################################################################################################################## 
## ## ### ## ######## ####################################################### ###################################################################################################### 
## ## ##     ######## ############################ ##########################        ############################################################################################### 
##    ###### ########     ######################## #######    ############### ######################################################   ###   ####################################### 
#####     ##   ###### ############################  ####   ################## ####################################################  ###  ###  ###################################### 
#######   ########### ############################       #################### #####################################################  ######  ####################################### 
########  ########### ############################ ########################## ######################################################  ####  ######################################## 
   ##                                                                                          ######################################  ##  ######################################### 
## ## ### ## ##### ########################################################################### #######################################    ########################################## 
## ## ##     ##### ##   ###################################################################### ###########                                                            ############## 
##    ###### #####                                                                             ###########                                                            ############## 
#####     ##   ######   ######################## ######## #################################### ###########  ########################################################  ############## 
############ ##########                          ######## ############################## ##### ###########  #######    ##    ##     ##    ##    ##    ##     #######  ############## 
############ ############ ######### ################ ####                                    # ###########  ####### ## ## ####### #### ## ## ##### ## #### #########  ############## 
#  ##     ## ########     ######### ################      ######## ################# ##### ### ###########  ####### ## ## ####### #### ## ## #####    #### #########  ############## 
## ## ### ## ######## ### ######### ################ #### ######## ################# #####     ###########  #######    ##    #### ####    ##    ## ## #### #########  ############## 
## ## ##     ######## ### ######### ################ #### ########                   ######### ###########  ########################################################  ############## 
##    ###### ########     ######### ################ #### ############# ############ ######### ###########  #########################      #########################  ############## 
#####     ##   ###### ############# ################ #### ############# ############ ######### ###########  ############################## #########################  ############## 
#######   ## ######## ############# ################ ####                            ######### ###########  ###########################    #########################  ############## 
############ ###################### ################ #### #################################### ###########  ############################## #########################  ############## 
#  ##     ## ######## ######        ################ #### #################################### ###########  #########################      #########################  ############## 
## ## ### ## ######## ####   ######       P                                                    ###########  ########################################################  ############## 
## ## ##     ######## ### ######### ################################ #### ######## ###########                                                                          ############ 
##    ###### ########     ######### ################################ #### ######## ##################################################  ##  ###########################  ############ 
#####     ##          ###           ################################ #### ######## ##################################################  ##  ###########################  ############ 
#######   ## ######## ### #########                                  #### ######## ##################################################  ##  ###########################  ############ 
############ ############ ######### #####################################           #################################################  ##  ###########################  ############ 
#  ##     ## ########     ######### ##################################### ######### #################################################  ##  ############################ ############ 
## ## ###### ######## ############# ##################################### #########                      ############################  ##  ############################     ######## 
## ## ####   ######## ############# ##################################### ###########################################################  ##  ############################  X  ######## 
##    ###### ########               ##################################### ###########################################################  ##  ############################              
#####     ##   ###### ## ########## ##################################### ###########################################################  ##  ############################              
############ ######## ################################################### #############################################################################################              
                                                                                                                                                                                     
