###############
P  ##     ## ##
## ## ### ## ##
## ## ##     ##
##    ###### ##
#####    X##   
###############
