###############
P  ##     ## ##
## ## ### ## ##
## ## ##     ##
##    ###### ##
####    X##    
###############
