############################################################################################
#    P######################################################################################
# ##########################################################################################
# ############# ############################################################################
#     ######### #######  #########################   ###   #################################
# #############  ####   ########################  ###  ###  ################################
# #############       ###########################  ######  #################################
# ############# ##################################  ####  ##################################
                          #########################  ##  ###################################
## #################################################    ####################################
#   ####################                                                            ########
                       #                                                            ########
#   ######### ######## #  ########################################################  ########
###           ######## #  #######    ##    ##     ##    ##    ##    ##     #######  ########
##### ########### #### #  ####### ## ## ####### #### ## ## ##### ## #### #########  ########
#     ###########     ##  ####### ## ## ####### #### ## ## #####    #### #########  ########
# ### ########### ######  #######    ##    #### ####    ##    ## ## #### #########  ########
# ### ########### #### #  ########################################################  ########
#     ########### ######  #########################      #########################  ########
# ############### ######  ############################## #########################  ########
# ############### #### #  ###########################    #########################  ########
# ############# # ######  ############################## #########################  ########
# ######        # ######  #########################      #########################  ########
# ####   ######           ########################################################  ########
# ### ######### #######                                                              #######
#     ######### ###################################  ##  ##########################  #######
  ###           ###################################  ##  ###########################  ######
# ### #########       #############################  ##  ###########################  ######
##### ######### ###################################  ##  ###########################  ######
#     ######### ###################################  ##  ###################################
# ############# ###################################  ##  ############################     ##
# ############# ###################################  ##  ############################  X  ##
#               ###################################  ##  ############################     ##
# ## ########## ###################################  ##  ############################     ##
# ###################################################################################     ##
                                                                                           #
